3222322122225212aaaa2221222252112222521122225211222252112222522aaaa2abb
1242124256500222211221225650022256500222565W022256500222565002221122112
2224222200000000000000020000V00200V00002000000020000W002000000000000024
32222120000000000000000000007000007000000000000000000000000000000000044
1242322000000000023220000000c00000c000000000000000000000000000000000022
2222124000000000021242000000bb000bb000000000000000000000000000000000000
21242220000000000423240000001200012000000000000000000000000000000000000
322221200000000002212220000024000240000000000000000000000000000000V0000
124232200000000000423240000044000440000000000000000000000000000002332bb
2222124000000d000022122000002200022000000000000000000000000000000000012
21242220000008000004222000000000000000000000000000000000000000000000024
32222120007V08007002212000000000000000000000000000000000000000000000044
12423220008809088000000000008888888000000000000000000000000000V00000022
22221242aaaa2aa2aaaa2aa2aaaa2aa2aaaa2aa2aaaa2aa2aaaa2aa2aaaa2aa2aaaa2aa
21242222211221222112212221122122211221222112212221122122211221222112212

